107
26
22 22 22 22 22 22 22 22 22 22 22 22 22 22 22 22 22 22 22 22 22 22 22 22 22 22 22 22 22 22 22 22 22 22 22 22 22 22 22 22 22 22 22 22 22 22 22 22 22 22 22 22 22 22 22 22 22 22 22 22 22 22 22 22 22 22 22 22 22 22 22 22 22 22 22 4  0  0  0  0  0  0  0  0  0  0  0  0  0  0  3  22 22 22 22 22 22 22 22 22 22 22 22 22 22 22 22
22 4  0  0  0  0  0  0  0  0  0  0  0  0  0  0  0  0  0  0  0  0  0  0  0  0  0  0  0  0  0  0  0  0  0  0  0  0  0  0  0  0  0  0  0  0  0  0  0  0  0  0  0  0  0  0  0  0  0  0  0  0  0  0  0  0  0  0  0  0  0  0  0  0  0  0  0  0  0  0  0  0  0  0  0  0  0  0  0  0  0  0  0  0  0  0  0  0  0  0  0  0  0  0  0  0  22
22 4  0  12 0  0  0  0  13 0  0  0  0  0  0  0  0  0  0  0  0  0  0  0  0  0  0  0  0  0  0  0  0  0  0  0  0  0  0  0  0  0  0  0  0  0  0  0  0  0  0  0  0  0  0  0  0  0  0  0  0  0  0  0  0  0  0  0  0  0  0  0  0  0  0  0  0  0  0  0  0  0  0  0  0  0  0  0  0  0  0  0  0  0  0  0  0  0  0  0  0  0  0  0  0  0  22
22 4  0  0  0  0  0  0  0  0  0  0  0  0  0  1  21 21 2  0  0  0  0  0  0  0  0  0  0  0  0  0  0  0  0  0  0  0  0  0  0  0  0  0  0  0  0  0  0  0  0  0  0  0  0  0  0  0  0  0  0  0  0  0  0  0  0  0  0  0  0  0  0  0  0  0  0  0  0  0  0  0  0  0  0  0  0  0  0  0  0  0  0  0  0  0  0  0  0  0  0  0  0  0  0  0  22
22 4  0  0  0  0  0  0  0  0  0  0  0  0  0  3  22 22 4  0  0  0  0  0  0  0  0  0  0  0  0  0  0  0  0  0  0  0  0  0  0  0  0  0  0  0  0  0  0  0  0  0  0  0  0  0  0  0  0  0  0  0  0  0  0  0  0  0  0  0  0  0  0  0  0  0  0  0  0  0  0  0  0  0  0  0  0  0  0  0  0  0  0  0  0  0  0  0  0  0  0  0  0  0  0  0  22
22 27 21 21 21 2  0  0  0  0  0  0  0  0  0  3  22 22 27 21 21 21 21 2  0  0  0  0  0  0  0  0  0  0  0  0  0  0  0  0  0  0  0  0  0  0  0  0  0  0  0  0  0  0  0  0  0  0  0  0  0  0  0  0  0  0  0  0  0  0  0  0  0  0  0  0  0  0  0  0  0  0  0  0  0  0  0  0  0  0  0  0  0  0  0  0  0  0  0  0  0  0  0  0  0  0  22
22 22 19 17 17 0  0  0  0  0  1  21 21 21 21 28 22 22 22 22 22 22 22 4  0  0  0  0  0  0  0  0  0  0  0  0  0  0  0  0  0  0  0  0  0  0  0  0  0  0  0  0  0  0  0  0  0  0  0  0  0  0  0  0  0  0  0  0  0  0  0  0  0  0  0  0  0  0  0  0  0  0  0  0  0  0  0  0  0  0  0  0  0  0  0  0  0  0  0  0  0  0  0  0  0  0  22
22 22 4  0  0  0  0  0  0  0  3  22 22 22 22 22 22 19 17 17 17 17 17 0  0  0  0  0  0  0  0  0  0  0  0  0  0  0  0  0  0  0  0  0  0  0  0  0  0  0  0  0  0  0  0  0  0  0  0  0  0  0  0  0  0  0  0  0  0  0  0  0  0  0  0  0  0  0  0  0  0  0  0  0  0  0  0  0  0  0  0  0  0  0  0  0  0  0  0  0  0  0  0  0  0  0  22
22 19 0  0  0  0  0  0  0  0  0  17 17 17 18 22 22 4  0  0  0  0  0  0  0  0  0  0  0  0  0  0  0  0  0  1  21 21 21 21 21 21 2  0  0  0  0  0  0  0  0  0  0  0  0  0  0  0  0  0  0  0  0  0  0  0  0  0  0  0  0  0  0  0  0  0  0  0  0  0  0  0  0  0  0  0  0  0  0  0  0  0  0  0  0  0  0  0  0  0  0  0  0  0  0  0  22
22 4  0  0  0  0  0  0  0  0  0  0  0  0  0  17 17 0  0  0  0  0  0  0  0  0  1  21 21 2  0  0  0  0  0  3  21 4  0  0  0  0  0  0  0  0  0  0  0  0  0  0  0  0  0  0  0  0  0  0  0  0  0  0  0  0  0  0  0  0  0  0  0  0  0  0  0  0  0  0  0  0  0  0  0  0  0  0  0  0  0  0  0  0  0  0  0  0  0  0  0  0  0  0  0  0  22
22 4  0  1  21 2  0  0  0  0  0  0  0  0  0  0  0  0  0  0  0  0  0  0  0  1  28 22 19 0  0  0  0  0  0  3  22 4  0  0  0  0  0  0  0  0  0  0  0  0  0  0  0  0  0  0  0  0  0  0  0  0  0  0  0  0  0  0  0  0  0  0  0  0  0  0  0  0  0  0  0  0  0  0  0  0  0  0  0  0  0  0  0  0  0  0  0  0  0  0  0  0  0  0  0  0  22
22 4  0  3  22 4  0  0  0  0  0  0  0  0  0  0  0  0  0  0  0  0  0  0  1  28 22 19 0  0  0  0  0  0  0  3  22 4  0  0  0  0  0  0  0  0  0  0  0  0  0  0  0  0  0  0  0  0  0  0  0  0  0  0  0  0  0  0  0  0  0  0  0  0  0  0  0  0  0  0  0  0  0  0  0  0  0  0  0  0  0  0  0  0  0  0  0  0  0  0  0  0  0  0  0  0  22
22 4  0  3  22 4  0  0  0  0  0  0  0  0  0  0  0  0  0  1  21 21 21 21 28 22 19 0  0  1  21 21 21 21 42 46 22 27 21 21 21 0  0  0  0  0  21 21 0  0  0  0  0  0  0  0  0  0  0  0  0  0  0  0  0  0  0  0  0  0  0  0  0  0  0  0  0  0  0  0  0  0  0  0  0  0  0  0  0  0  0  0  0  0  0  0  0  0  0  0  0  0  0  0  0  0  22
22 4  3  28 22 27 21 21 21 21 21 21 21 21 21 21 21 2  0  3  22 22 22 22 22 19 0  0  0  3  22 22 22 22 22 22 22 22 22 22 22 22 4  0  3  22 22 22 0  0  0  0  0  0  0  0  0  0  0  0  0  0  0  0  0  0  0  0  0  0  0  0  0  0  0  0  0  0  0  0  0  0  0  0  0  0  0  0  0  0  0  0  0  0  0  0  0  0  0  0  0  0  0  0  0  0  22
22 4  0  0  0  0  0  0  0  0  0  0  0  0  0  0  22 4  0  3  22 0  0  0  0  0  0  0  0  0  0  0  0  0  0  0  0  0  0  0  0  0  0  0  18 22 22 22 22 22 22 22 22 22 22 22 22 22 22 22 19 17 17 17 17 17 17 17 17 17 18 22 22 22 22 4  0  0  0  0  0  0  0  0  0  0  0  0  0  0  0  18 22 22 22 22 22 19 17 17 17 17 17 17 17 18 22
22 4  0  0  0  0  0  0  0  0  0  0  0  0  0  0  22 4  0  3  22 0  0  0  0  0  0  0  0  0  0  0  0  0  0  0  0  0  0  0  10 0  0  0  0  17 17 17 18 22 22 22 22 22 22 22 22 22 22 22 4  0  0  16 0  0  0  0  0  0  0  17 18 22 22 4  0  0  0  0  0  0  0  0  0  0  0  0  0  0  0  0  18 22 22 22 22 4  0  0  0  0  0  0  0  3  22
22 4  0  0  0  0  0  0  0  0  0  0  0  0  0  0  22 45 43 46 22 0  0  0  0  0  0  0  0  0  0  0  0  1  21 21 2  0  0  23 24 25 0  0  0  0  0  0  0  17 17 18 22 22 22 22 22 22 22 19 0  0  10 0  11 0  0  0  0  0  0  0  0  17 17 0  0  0  0  9  0  0  0  0  1  21 2  0  0  0  0  0  0  18 22 22 22 4  0  0  0  0  0  0  0  3  22
22 4  0  0  0  0  43 0  0  0  0  0  0  1  21 28 22 22 22 22 22 0  0  0  0  0  0  0  0  0  0  0  0  0  0  0  0  0  0  0  0  0  0  0  0  0  0  0  0  0  0  0  0  0  0  0  0  0  0  0  0  0  0  0  0  0  0  0  0  0  0  0  0  0  0  0  0  0  0  0  0  0  0  0  0  0  0  0  0  0  0  0  0  0  0  0  0  0  0  0  0  0  0  0  0  0  22
22 4  0  0  0  0  0  0  0  0  0  0  0  3  22 22 22 22 0  0  0  0  0  0  0  0  0  0  0  0  0  0  0  0  0  0  0  0  0  0  0  0  0  0  0  0  0  0  0  0  0  0  0  0  0  0  0  0  0  0  0  0  0  0  0  0  0  0  0  0  0  0  0  0  0  0  0  0  0  0  0  0  0  0  0  0  0  0  0  0  0  0  0  0  0  0  0  0  0  0  0  0  0  0  0  0  22
22 4  0  0  0  0  0  0  0  0  0  0  0  0  0  0  0  0  0  0  0  0  0  0  0  0  0  0  0  0  0  0  0  0  0  0  0  0  0  0  0  0  0  0  0  0  0  0  0  0  0  0  0  0  0  0  0  0  0  0  0  0  0  0  0  0  0  0  0  0  0  0  0  0  0  0  0  0  0  0  0  0  0  0  0  0  0  0  0  0  0  0  0  0  0  0  0  0  0  0  0  0  0  0  0  0  22
22 4  0  0  0  0  0  0  0  0  0  0  0  0  0  0  0  0  0  0  0  0  0  0  0  0  0  0  0  0  0  0  0  0  0  0  0  0  0  0  0  0  0  0  0  0  0  0  0  0  0  0  0  0  0  0  0  0  0  0  0  0  0  0  0  0  0  0  0  0  0  0  0  0  0  0  0  0  0  0  0  0  0  0  0  0  0  0  0  0  0  0  0  0  0  0  0  0  0  0  0  0  0  0  0  0  22
22 4  0  0  0  0  0  0  0  0  0  0  0  0  0  0  0  0  0  0  0  0  0  0  0  0  0  0  0  0  0  0  0  0  0  0  0  0  0  0  0  0  0  0  0  0  0  0  0  0  0  0  0  0  0  0  0  0  0  0  0  0  0  0  0  0  0  0  0  0  0  0  0  0  0  0  0  0  0  0  0  0  0  0  0  0  0  0  0  0  0  0  0  0  0  0  0  0  0  0  0  0  0  0  0  0  22
22 4  0  0  0  0  0  0  0  0  1  42 43 44 21 21 2  0  0  0  0  0  0  0  0  0  0  0  0  0  0  0  0  1  21 2  0  0  0  0  0  0  0  0  0  0  0 0  0  0  0  0  17 17 17 17 17 17 17 0  0  1  21 21 21 2  0  0  0  0  0  0  0  0  0  0  0  0  0  23 24 25 0  0  3  22 4  0  0  0  0  0  0  0  18 22 22 4  0  0  0  0  0  0  0  3  22
22 4  0  0  0  0  0  0  0  0  3  22 22 22 22 22 4  0  0  0  0  0  0  0  0  0  0  0  0  0  0  0  0  3  22 4  0  0  0  0  0  0  0  1  21 21 21 21 2  0  0  0  9  0  0  0  0  9  0  0  0  3  22 22 22 4  0  0  0  0  0  0  0  0  0  0  0  0  0  0  0  0  0  0  3  22 4  0  0  0  0  0  0  0  0  17 17 0  0  0  0  0  0  0  0  3  22
22 4  9  0  10 0  0  0  0  0  3  22 22 22 22 22 4  0  0  0  1  21 21 21 21 2  0  0  9  0  0  0  0  3  22 27 42 43 2  0  0  0  0  3  22 22 22 22 4  10 0  1  21 2  0  0  1  21 2  11 0  3  6  22 22 4  0  0  0  0  0  0  0  9  0  0  10 9  0  0  11 0  0  1  21 5  21 2  0  0  0  0  0  0  0  0  0  0  0  10 11 0  0  9  0  3  22
5  27 21 21 21 42 43 43 44 21 28 22 22 22 22 22 27 21 21 21 28 22 22 22 22 27 21 21 21 21 42 43 44 28 22 22 22 22 4  0  0  0  0  3  22 22 22 5  21 21 21 21 21 21 21 21 21 21 21 21 42 46 22 22 22 4  0  0  0  0  0  1  21 21 21 21 21 21 21 21 21 21 21 21 6  22 5  21 21 21 21 21 21 21 21 21 21 21 21 21 21 21 21 21 21 21 6
