107
26
22 22 22 22 22 22 22 22 22 22 22 22 22 22 22 22 22 22 22 22 22 22 22 22 22 22 22 22 22 22 22 22 22 22 22 22 22 22 22 22 22 22 22 22 22 22 22 22 22 22 22 22 22 22 22 22 22 22 22 22 22 22 22 22 22 22 22 22 22 22 22 22 22 22 22 4  0  0  0  0  0  0  0  0  0  0  0  0  0  0  3  22 22 22 22 22 22 22 22 22 22 22 22 22 22 22 22
22 4  0  0  0  0  0  0  0  0  0  0  0  0  0  0  0  0  0  0  0  0  0  0  0  0  0  0  0  0  0  0  0  0  22 22 22 0  0  0  0  0  0  0  22 0  0  0  0  0  0  0  0  0  0  0  0  0  0  0  0  0  0  0  0  0  0  0  0  0  0  0  0  0  0  0  0  0  0  0  0  0  0  0  0  0  0  0  0  0  0  0  0  0  0  0  0  0  0  0  0  0  0  0  0  0  22
22 4  0  12 0  0  0  0  13 0  0  0  0  0  0  0  0  0  0  0  0  0  0  0  0  0  0  0  0  0  0  0  22 22 22 0  0  0  0  0  0  0  0  0  22 22 22 0  0  0  0  0  0  0  0  0  0  0  0  0  0  0  0  0  0  0  0  0  0  0  0  0  0  0  0  0  0  0  0  0  0  0  0  0  0  0  0  0  0  0  0  0  0  0  0  0  0  0  0  0  0  0  0  0  0  0  22
22 4  0  0  0  0  0  0  0  0  0  0  0  0  0  1  21 21 2  0  0  0  0  0  0  0  0  0  0  0  0  22 22 0  0  0  0  0  0  0  0  0  0  0  0  0  22 22 0  0  0  0  0  0  0  0  0  0  0  0  0  0  0  0  0  0  0  0  0  0  0  0  0  0  0  0  0  0  0  0  0  0  0  0  0  0  0  0  0  0  0  0  0  0  0  0  0  0  0  0  0  0  0  0  0  0  22
22 4  0  0  0  0  0  0  0  0  0  0  0  0  0  3  22 22 4  0  0  0  0  0  0  0  0  0  0  0  0  0  0  0  0  0  0  0  0  0  0  0  0  0  0  0  0  22 0  0  0  0  0  0  0  0  0  0  0  0  0  0  0  0  0  0  0  0  0  0  0  0  0  0  0  0  0  0  0  0  0  0  0  0  0  0  0  0  0  0  0  0  0  0  0  0  0  0  0  0  0  0  0  0  0  0  22
22 27 21 21 21 2  0  0  0  0  0  0  0  0  0  3  22 22 27 21 21 21 21 2  0  0  0  0  0  0  0  0  0  0  0  0  0  0  0  0  0  0  0  0  0  0  0  0  0  0  0  0  0  0  0  0  0  0  0  0  0  0  0  0  0  0  0  0  0  0  0  0  0  0  0  0  0  0  0  0  0  0  0  0  0  0  0  0  0  0  0  0  0  0  0  0  0  0  0  0  0  0  0  0  0  0  22
22 22 19 17 17 0  0  0  0  0  1  21 21 21 21 28 22 22 22 22 22 22 22 4  0  0  0  0  0  0  0  0  0  0  0  0  0  0  0  0  0  0  0  0  0  0  0  0  0  0  0  0  0  0  0  0  0  0  0  0  0  0  0  0  0  0  0  0  0  0  0  0  0  0  0  0  0  0  0  0  0  0  0  0  0  0  0  0  0  0  0  0  0  0  0  0  0  0  0  0  0  0  0  0  0  0  22
22 22 4  0  0  0  0  0  0  0  3  22 22 22 22 22 22 19 17 17 17 17 17 0  0  0  0  0  0  0  0  0  0  0  0  0  0  0  0  0  0  0  0  0  0  0  0  0  0  0  0  0  0  0  0  0  0  0  0  0  0  0  0  0  0  0  0  0  0  0  0  0  0  0  0  0  0  0  0  0  0  0  0  0  0  0  0  0  0  0  0  0  0  0  0  0  0  0  0  0  0  0  0  0  0  0  22
22 19 0  0  0  0  0  0  0  0  0  17 17 17 18 22 22 4  0  0  0  0  0  0  0  0  0  0  0  0  0  0  0  0  0  1  21 21 21 21 21 21 0  0  0  0  0  0  0  0  0  0  0  0  0  0  0  0  0  0  0  0  0  0  0  0  0  0  0  0  0  0  0  0  0  0  0  0  0  0  0  0  0  0  0  0  0  0  0  0  0  0  0  0  0  0  0  0  0  0  0  0  0  0  0  0  22
22 4  0  0  0  0  0  0  0  0  0  0  0  0  0  17 17 0  0  0  0  0  0  0  0  0  1  21 21 2  0  0  0  0  0  3  22 22 0  0  0  0  0  0  0  0  0  0  0  0  0  0  0  0  0  0  0  0  0  0  0  0  0  0  0  0  0  0  0  0  0  0  0  0  0  0  0  0  0  0  0  0  0  0  0  0  0  0  0  0  0  0  0  0  0  0  0  0  0  0  0  0  0  0  0  0  22
22 4  0  1  21 2  0  0  0  0  0  0  0  0  0  0  0  0  0  0  0  0  0  0  0  1  28 22 19 0  0  0  0  0  0  3  22 4  0  0  0  0  0  0  0  0  0  0  0  0  0  0  0  0  0  0  0  0  0  0  0  0  0  0  0  0  0  0  0  0  0  0  0  0  0  0  0  0  0  0  0  0  0  0  0  0  0  0  0  0  0  0  0  0  0  0  0  0  0  0  0  0  0  0  0  0  22
22 4  0  3  22 4  0  0  0  0  0  0  0  0  0  0  0  0  0  0  0  0  0  0  1  28 22 19 0  0  0  0  0  0  0  3  22 4  0  0  0  0  0  0  0  0  0  0  0  0  0  0  0  0  0  0  0  0  0  0  0  0  0  0  0  0  0  0  0  0  0  0  0  0  0  0  0  0  0  0  0  0  0  0  0  0  0  0  0  0  0  0  0  0  0  0  0  0  0  0  0  0  0  0  0  0  22
22 4  0  3  22 4  0  0  0  0  0  0  0  0  0  0  0  0  0  1  21 21 21 21 28 22 19 0  0  0  1  21 21 21 42 46 22 27 21 21 21 0  0  0  0  0  21 21 21 21 21 0  0  21 21 21 21 21 21 21 0  0  0  0  0  0  0  0  0  0  0  0  0  0  0  0  0  0  0  0  0  0  0  0  0  43 0  0  0  0  0  0  0  0  0  0  0  0  0  0  0  0  0  0  0  0  22
22 4  3  28 22 27 21 21 21 21 21 21 21 21 21 21 21 2  0  3  22 22 22 22 22 19 0  0  0  0  3  22 22 22 22 22 22 22 22 22 22 22 4  0  3  22 22 22 22 0  0  0  0  0  0  0  0  0  0  22 0  0  0  0  0  0  0  0  0  0  0  0  0  0  0  0  0  0  0  0  0  0  0  0  0  0  0  0  0  0  0  0  0  0  0  0  0  0  0  0  0  0  0  0  0  0  22
22 4  3  22 22 22 22 22 22 22 0  0  0  0  0  3  22 4  0  3  22 22 22 0  0  0  0  0  0  0  0  22 22 22 0  0  22 22 22 0  0  0  0  0  3  22 22 22 22 0  0  0  0  0  0  0  0  0  0  22 0  0  0  0  0  0  0  0  0  0  0  0  0  0  0  0  0  0  0  0  0  0  0  0  0  0  0  0  0  0  0  0  0  0  0  0  0  0  0  0  0  0  0  0  0  0  22
22 4  3  22 22 22 22 0  0  0  0  0  0  0  0  3  22 4  0  3  22 22 0  0  0  0  0  0  0  0  0  0  0  22 22 0  0  0  0  0  0  0  0  0  3  22 22 22 22 0  0  0  0  0  0  0  0  0  0  22 4  0  0  0  0  0  0  0  0  0  0  22 0  0  0  0  0  0  0  0  0  0  0  0  0  0  0  0  0  0  0  0  0  0  0  0  0  0  0  0  0  0  0  0  0  3  22
22 4  3  22 0  0  0  0  0  0  0  0  0  0  0  3  22 45 43 46 22 22 0  0  0  0  0  0  0  0  0  0  0  0  0  22 22 0  0  0  0  0  0  0  3  22 22 22 22 21 21 0  0  0  21 21 21 21 21 22 4  0  0  0  0  0  0  0  0  0  0  22 0  0  0  0  0  0  0  0  0  0  43 0  0  0  0  43 0  0  0  0  0  0  0  43 0  0  0  1  21 21 21 21 21 21 22
22 4  3  22 0  0  0  0  0  0  0  0  0  1  21 28 22 22 22 22 22 0  0  0  0  0  0  0  0  0  0  0  0  0  0  0  0  0  0  0  0  0  1  21 28 22 0  0  0  0  0  0  0  0  0  0  0  3  22 19 0  0  0  0  0  0  0  0  0  0  0  0  0  0  0  0  0  0  0  0  0  0  0  0  0  0  0  0  0  0  0  0  0  0  0  0  0  0  0  0  0  0  0  0  0  0  22
22 4  0  0  0  0  0  0  0  0  0  0  0  3  22 22 22 22 0  0  0  0  0  0  0  0  0  0  0  0  0  0  0  0  0  0  0  0  0  0  0  0  0  0  0  0  0  0  0  0  0  0  0  0  0  0  0  3  22 4  0  0  0  0  0  0  0  0  0  0  0  0  43 0  0  0  0  0  0  0  0  0  0  0  0  0  0  0  0  0  0  0  0  0  0  0  0  0  0  0  0  0  0  0  0  0  22
22 4  0  0  0  0  0  0  0  0  0  0  0  0  0  0  0  0  0  0  0  0  0  0  0  0  0  0  0  0  0  0  0  0  0  0  0  0  0  0  0  0  0  0  0  0  0  0  0  0  0  0  0  0  0  0  0  3  22 4  0  0  0  0  0  0  0  0  0  0  43 0  22 0  0  0  0  0  0  0  0  0  0  0  0  0  0  0  0  0  0  0  0  0  0  0  0  0  0  0  0  0  0  0  0  0  22
22 4  0  0  0  0  0  0  0  0  0  0  0  0  0  0  0  0  0  0  0  0  0  0  0  0  0  0  0  0  0  0  0  0  0  0  0  0  0  0  0  0  0  0  0  0  0  0  0  0  0  0  0  0  0  0  0  3  22 4  0  0  0  0  0  0  0  0  0  0  22 0  22 0  0  0  0  0  0  43 0  0  0  0  0  0  0  0  0  0  0  0  0  0  0  0  0  0  0  0  0  0  0  0  0  0  22
22 4  1  21 2  0  0  0  0  0  0  0  0  0  0  0  0  0  0  0  0  0  0  0  1  21 21 21 21 21 2  0  0  0  0  0  0  0  0  0  0  0  0  0  0  0  0  0  0  0  0  0  0  0  0  0  0  3  22 4  0  0  0  0  0  0  0  0  0  0  22 0  22 0  0  0  0  0  0  0  0  0  0  0  0  0  0  0  0  0  0  0  0  0  0  0  0  0  0  0  0  0  0  0  0  0  22
22 4  3  22 27 2  0  0  0  0  1  21 21 21 21 21 2  0  0  0  0  0  0  1  28 19 0  0  0  0  0  0  0  1  21 2  0  0  0  0  0  0  0  0  0  0  1  21 2  0  0  0  0  0  0  0  0  3  22 4  0  0  0  0  43 0  0  0  0  0  22 0  22 0  0  0  0  0  0  0  0  0  0  0  0  0  0  0  0  0  0  0  0  0  0  0  0  0  0  0  0  0  0  0  0  3  22
22 4  3  22 22 4  0  0  0  0  3  22 22 22 22 22 4  0  0  0  0  0  1  28 22 4  0  0  0  0  0  0  0  3  22 4  0  0  0  0  0  0  0  1  21 21 28 22 4  0  0  0  0  0  0  0  0  3  22 4  0  0  0  0  22 0  0  0  0  0  22 0  22 0  0  0  0  0  0  0  0  0  0  0  0  0  0  0  0  0  0  0  0  0  0  0  0  0  0  0  0  0  0  0  0  3  22
22 4  3  22 22 4  0  0  0  1  28 22 22 22 22 22 4  0  0  0  1  21 28 22 22 4  0  0  0  0  0  0  0  3  22 27 42 43 2  0  0  0  0  3  22 22 22 22 4  0  0  0  0  0  0  0  0  3  22 27 2  0  0  0  22 0  0  0  0  0  22 0  22 0  0  0  43 0  0  0  0  0  0  0  0  0  0  0  0  0  0  0  0  0  0  0  0  0  0  0  0  0  0  0  0  3  22
5  45 46 22 22 45 43 43 44 28 22 22 22 22 22 22 27 21 21 21 28 22 22 22 22 27 21 21 21 21 42 43 44 28 22 22 22 22 4  0  0  0  0  3  22 22 22 22 27 21 21 21 21 21 21 21 21 28 22 22 27 2  0  0  22 0  0  0  0  0  22 0  22 0  0  0  0  0  0  0  0  0  0  0  0  0  0  0  0  0  0  0  0  0  0  0  0  0  0  0  0  0  0  0  0  3  22
